######s#######################
#####  ### #  #### # ### ## ##
######  ## # ### ### ### ## ##
## ### ##  #  #  ##   ##  # ##
##                          ##
#                            #
#                   m        #
#         m                  #
#                            #
#                            #
#############e################