##############################
#####  ### #  #### # ### ## ##
######  ## # ### ### ### ## ##
## ### ##  #  #  ##   ##  # ##
##############################
